Date,Description,Debit,Credit,Balance
2025-01-14,Account Created.,,,0.00
2025-01-14,Money In,500.00,,500.00
2025-01-14,Money Out,,50.00,450.00
2025-01-14,Savings Test 1,500.00,,950.00
2025-01-14,Savings Test 2,500.00,,1450.00
2025-01-14,Savings Disable Test 1,500.00,,1950.00
2025-01-14,Auto Savings Test 1,500.00,,2450.00
2025-01-14,Credit Test,,500.00,1950.00
