Date,Description,Debit,Credit,Balance
2025-01-15,Account Created.,,,0.00
2025-01-15,Salary,500.00,,500.00
2025-01-15,Electronics,,250.00,250.00
2025-01-15,Clear balance,,250.00,0.00
2025-01-15,Salary,500.00,,500.00
2025-01-15,Salary 2,500.00,,1000.00
2025-01-15,Salary 3,500.00,,1500.00
