Date,Description,Debit,Credit,Balance
2025-01-10,Account Created.,,,0.00
2025-01-10,Salary,5000.00,,5000.00
2025-01-10,Stationeries,,50.00,4950.00
2025-01-10,Food,,20.00,4930.00
2025-01-10,Electronics,,200.00,4730.00
2025-01-10,Utility,,700.00,4030.00
2025-01-10,Electronics,,500.00,3530.00
